---config@码表分类=主码-用户码表
---config@码表别名=用户自定义
$ddcmd(YangKyle1024@FoxMail.com,FoxMail )	;CMDmail
$ddcmd(YangKyle1024@QQ.com,QQ )	;CMDmail
$ddcmd(YangKyle1024@OutLook.com,OutLook )	;CMDmail
$ddcmd(YangKyle1024@ProTon.me,ProTon )	;CMDmail
$ddcmd(YangKyle1024@iCloud.com,iCloud )	;CMDmail
$ddcmd(YangKyle1024@Gmail.com,Gmail )	;CMDmail
助眠	eghn
腰间盘突出	eutb
无障碍	fbdj
无感知度	fdty
开发者	gnft
水狐	iiqt
$ddcmd(newkey(;CMDmail),Mail)	mail
发行版	ntth
初音未来	pufg
Plants V.S. Zombies	pvz
猫啃	qtkh
推特	rwtr
技术栈	rssg
植物大战僵尸	stdn
配置文件	slyw
选择器	trkk
我的世界	tral
得意黑	tulf
命令行	wwtf
什么感觉	wtdi
假面骑士	wdcf
创意工坊	wuaf
追我	wntr
传说之下	wypg
192.168.31.1	wifi
弹幕	xuaj
油猴	imqt#固
